[English]
Menu Language=&English

[Chinese]
Menu Language=&Русский [перевод от www.ddvhouse.ru]

DIR A = Слот A
DIR B = Слот B
DIR C = Слот C
CD = CD
Fetch = Восстановить
Music = Музыка
Game = Игра
Tools = Инструменты
Rom Explorer = Обзор ROM
Srm Manager = SRM-менеджер
Load V.S.C = Загрузить V.S.C
Rom Info = ROM Инфо
Game Genie = Game Genie
Ping = Отклик (Ping)
Set Rewind = Включить повторы
Samples For Rewind = Просмотр повторов
search cheats = Поиск читов
Load cheats = Загрузить чит
Cheats = Читы
Turn On all cheats = Включить читы
Turn Off all cheats = Выключить читы
Start Play Movie = Проиграть фильм
Stop Play Movie = Остановить фильм
Start Movie Record = Записать фильм
Stop Movie Record = Остановить запись
History = История
System = Система
Switch MENU = Переключить меню
Enable Short Cut = Включить горячие клавиши
Disable Short Cut = Выключить горячие клавиши

File = Файл
Load MD = Загрузить MD
Load 32X = Загрузить 32X
Load ISO = Загрузить ISO
Boot CD = Загрузить CD
Close = Свернуть
Netplay = Игра по сети
Load State as = Загрузить состояние как
Save State as = Сохранить состояние как
Load State = Загрузить состояние
Save State = Сохранить состояние
Change State = Сменить состояние
Rom History = История ROM
Quit = Выход

Video = Видео
Full Screen = Полный экран
Windowed = Оконный режим
VSync = Вертикальная синхронизация
Stretch = Растяжение
Use Custom Screen = Использовать пользовательское разрешение
Settings = Настройка
Color = Цвет
Custom Screen = Разрешение
Register Plugin = Плагины
Adjust glScanlines = Коррекция растровости
Emulate TV Size = Эмулирование TV
NTSC D-1 = NTSC D-1
NTSC DV = NTSC DV
PAL = PAL
PAL D1 = PAL D1
Color Map = Карта цветов
Default = По умолчанию
RGB Smooth=Размытие RGB
Glossiness=Глянцевость
RGB Swell=Выпуклость RGB 
FixH = FixH
Render = Визуализация
32 О»
Antialiasing = Сглаживание
SpecialEffect = Специальные эфффекты
Normal = Нормальный
drawDouble = Двойной
glDouble = Двойное
glScanlines = Растровое
glHigh Light = glHigh Light
glNTSC3.58(WIP) = glNTSC3.58(WIP)
glMotion Blur = glMotion Blur
Gens32 antialiasing = Gens32 сглаживание
HQ2X = HQ2X
LCD = LCD
Gens32 2X = Gens32 2X
Magic Colors = Магия цвета
1:1 Scanline = 1:1 Растр
Blur = Размытый
Use Plugin = Использовать плагин
Crapy TV = Crapy TV
TV Mode = Режим ТВ
Strange Colors = Усиленные цвета
Array = Массив
Monitor Plus = Монитор
MM2X = MM2X
Dot Monitor = Точечный режим
RGB Remix = RGB Remix
Gens32 Antialiasing II = Gens32 Antialiasing II
Gens32 Antialiasing II With Motion Blur = Gens32 Antialiasing II With Motion Blur
Gens32 Antialiasing III = Gens32 Antialiasing III
Super TV = Супер ТВ
Frame Skip = Пропуск кадров
Auto = Авто
Screen shot = Скриншот
Save MDD = Сохранить MDD 

Audio = Аудио
Enable = Включить
Stereo = Стерео
Show Volume LED = Показывать уровень громкости
3d Surround = 3D объем (3d Surround) 
Rate = Частота
Bits = Битрейт
Set Volume = Громкость
192MH improve = Улучшение 192MH
Force Use Software = Использовать программное ускорение
YM2612 High Quality = YM2612 Высокое качество
Cool Music = Клёвая музыка
SSGEG Enable = Включить SSGEG
Start Dump = Начать дамп
Stop Dump = Остановить дамп

Hardware = Оборудование
Country = Страна
Auto detect = Автоопределение
Japan (NTSC) = Япония (NTSC)
USA (NTSC) = США (NTSC)
Europe (PAL) = Европа (PAL)
Japan (PAL) = Япония (PAL)
Auto detection order = Порядок автоопределения
Hard Reset= Сброс оборудования
Low IDIE = Низкий IDIE
Fast Mode =Быстрый режим

Option = Настройки
Misc = Разное
Joypad = Управление
Directories = Пути и папки
Bios/Misc Files = Файлы BIOS и прочее 
Map Buttons = Карта клавиш
Protected Saves = Защищенные сохранения
Hide Menu = Скрыть меню
Mouse Enable = Использовать мышь
Spy 7z = Слежение за 7z ROM
Good Dump = Good Dump
U.S.A = США
Japan = Япония
Europe = Европа
Fixed Rom = Исправить ROM
Priority = Приоритет
Lowest = Низкий
Below Normal = Ниже нормы
Normal = Нормальный
Above Normal = Выше нормы
High = Высокий
Realtime = В реальном времени
Turbo Input = Включить режим Turbo
SEGA CD STUFF = SEGA CD STUFF
Current CD Drive = Выбранный CD-привод
No Drive detected = Приводов не определено
Sega CD SRAM Size = Объем Sega CD SRAM
None = Нет
Auto Speed Up = Автоускорение
Disable = Отключено
2X= 2x
4X = 4x
CDDA Device = CDDA устройство
MPG123 = MPG123
Direct Show = Direct Show
Load RAM Cart = Загрузить карту памяти
Load config = Загрузить настройки
Save config as = Сохранить настройки

Help = Языки и помощь
About = О программе...

OK = OK
Cancel = Отмена
Delete = Удалить

Informations GG = Informations GG
Game Genie info 1 = Game Genie info 1
Game Genie info 2 = Game Genie info 2
Game Genie info 3 = Game Genie info 3
Game Genie info 4 = Game Genie info 4
Add Code = Добавить код
Remove selected codes = Удалить выбранные коды
Desactive all codes = Деактивировать все коды
Help = Помощь

fps per sample =fps примера
Number of sample =Номер примера

Change = Изменить
Load = Загрузить

System = Система
Auto Fix Checksum = Автоподгон чексуммы
Fast Blur = Быстрое сглаживание
Auto Pause = Авто пауза
Show Sega-CD LED = Показывать табло SEGA-CD
FPS = FPS
Double Sized  = Удвоенный размер
Transparency = Прозрачность
Message = Сообщение
Intro = Вступление
Effect Color = Цветовые эффекты

Accept = Применить
Browser = Обзор
Rom Path: = Путь к ROM
Stop = Стоп

Contrast = Контраст
Brightness = Яркость
Greyscale = Оттенки серого
Invert = Инвертировать
Apply = Применить

Custom Screen = Разрешение экрана
Full Screen = Полный экран
Windowed = Оконный режим
Horizontal: = По горизонтали
Vertical: = По вертикали

Color: = Цвет:
Red: = Красный:
Green: = Зеленый:
Blue: = Голубой:
Number: = Число:

Setting directories = Настройки путей
Save static = Сохранения
Sram static = SRAM
Bram static = BRAM
Wav static = WAV
Gym static = GYM
Shot static = Скриншоты
Patch static = Патчи
IPS static = IPS

Setting Genesis bios file = Sega Genesis (Mega Drive) BIOS
Genesis bios static = Путь к BIOS
Setting 32X bios files = Sega 32X BIOS
M SH2 bios static = M SH2 BIOS
S SH2 bios static = S SH2 BIOS
Setting SEGA CD bios files = Sega CD BIOS
US bios static = US BIOS
EU bios static = EU BIOS
JA bios static = JA BIOS
Setting misc files = Прочие пути
CGOffline static = CGOffline
Manual static = Справка